ASSOC	파일 확장명 연결을 보여주거나 수정합니다. (association)
ATTRIB	파일 속성을 표시하거나 바꿉니다. (attirbute)
BREAK	확장된 CTRL+C 검사를 설정하거나 지웁니다.
BCDEDIT	부팅 로딩을 제어하기 위해 부팅 데이터베이스에서 속성을 설정합니다.
CACLS	파일의 액세스 컨트롤 목록(ACL)을 표시하거나 수정합니다.
CALL	한 일괄 프로그램에서 다른 일괄 프로그램을 호출합니다.
CD	해당하는 디렉토리로 진입합니다.
CHCP	활성화된 코드 페이지의 번호를 표시하거나 설정합니다. (change code page)
CHDIR	CD 와 같은 역할을 수행합니다. 디렉토리로 진입합니다.
CHKDSK	디스크를 검사하고 상태 보고서를 표시합니다. (check disk)
CHKNTFS	부팅하는 동안 디스크 확인을 화면에 표시하거나 변경합니다. (check NTFS)
CLS	CMD 화면에 표시된 것을 모두 지웁니다. (clear screen)
CMD	Windows 명령 인터프리터의 새 인스턴스를 시작합니다. (command)
COLOR	콘솔의 기본색과 배경색을 설정합니다.
COMP	두 개 또는 여러 개의 파일을 비교합니다. (compare)
COMPACT	NTFS 분할 영역에 있는 파일의 압축을 표시하거나 변경합니다.
CONVERT	FAT 볼륨을 NTFS로 변환합니다. 현재 드라이브는 변환할 수 없습니다.
COPY	하나 이상의 파일을 다른 위치로 복사합니다.
DATE	날짜를 보여주거나 설정합니다.
DEL	하나 이상의 파일을 지웁니다. (delete)
DIR	디렉터리에 있는 파일과 하위 디렉터리 목록을 보여줍니다. (directory)
DISKCOMP	두 플로피 디스크의 내용을 비교합니다. (disk compare)
DISKCOPY	플로피 디스크의 내용을 다른 플로피 디스크로 복사합니다. (disk copy)
DISKPART	디스크 파티션 속성을 표시하거나 구성합니다. (disk partition)
DOSKEY	명령줄을 편집하고, Windows 명령을 다시 호출하고, 매크로를 만듭니다.
DRIVERQUERY	현재 장치 드라이버 상태와 속성을 표시합니다. (driver query)
ECHO	메시지를 표시하거나 ECHO를 사용 또는 사용하지 않습니다.
ENDLOCAL	배치 파일에서 환경 변경의 지역화를 끝냅니다. (end local)
ERASE	하나 이상의 파일을 지웁니다.
EXIT	CMD.EXE 프로그램(명령 인터프리터)을 마칩니다.
FC	두 파일 또는 파일의 집합을 비교하여 다른 점을 표시합니다.
FIND	파일에서 텍스트 문자열을 찾습니다.
FINDSTR	파일에서 문자열을 찾습니다. (find string)
FOR	파일 집합에서 각 파일에 대해 지정된 명령을 실행합니다.
FORMAT	Windows에서 사용할 디스크를 포맷합니다.
FSUTIL	파일 시스템 속성을 표시하거나 구성합니다. (file system utility)
FTYPE	파일 확장 연결에 사용되는 파일 형식을 표시하거나 수정합니다. (file type)
GOTO	Windows 명령 인터프리터가 일괄 프로그램에서 이름표가 붙여진 줄로 이동합니다. (go to)
GPRESULT	컴퓨터 또는 사용자에 대한 그룹 정책 정보를 표시합니다. (group policy result)
GRAFTABL	Windows가 그래픽 모드에서 확장 문자 세트를 표시할 수 있게 합니다.
HELP	Windows 명령어에 관한 도움말을 제공합니다.
ICACLS	파일과 디렉터리에 대한 ACL을 표시, 수정, 백업 또는 복원합니다.
IF	일괄 프로그램에서 조건 처리를 수행합니다.
IPCONFIG	윈도우 TCP/IP 설정상태 확인 명령어 (IP configuration)
LABEL	디스크의 볼륨 이름을 만들거나, 바꾸거나, 지웁니다.
MD	디렉터리를 만듭니다. (make directory)
MKDIR	디렉터리를 만듭니다. (make directory)
MKLINK	기호화된 링크와 하드 링크를 만듭니다. (make link)
MODE	시스템 장치를 구성합니다.
MORE	출력을 한번에 한 화면씩 표시합니다.
MOVE	하나 이상의 파일을 한 디렉터리에서 다른 디렉터리로 옮깁니다.
OPENFILES	파일 공유에서 원격 사용자에 의해 열린 파일을 표시합니다. (open files)
PATH	실행 파일의 찾기 경로를 보여주거나 설정합니다.
PAUSE	배치 파일의 처리를 보류하고 메시지를 보여줍니다.
POPD	PUSHD 명령으로 저장된 디렉터리로 바꿉니다. (pod directory)
PRINT	텍스트 파일을 인쇄합니다.
PROMPT	Windows 명령 프롬프트를 바꿉니다.
PUSHD	현재 디렉터리를 저장한 후 디렉터리를 바꿉니다. (push directory)
RD	디렉터리를 지웁니다. (remove directory)
RECOVER	불량이거나 결함이 있는 디스크에서 읽을 수 있는 정보를 복구합니다.
REM	배치 파일 또는 CONFIG.SYS에서 주석을 기록합니다.
REN	파일 이름을 바꿉니다. (rename)
RENAME	파일 이름을 바꿉니다.
REPLACE	파일을 대체합니다.
RMDIR	디렉터리를 지웁니다. (remove directory)
ROBOCOPY	파일과 디렉터리 트리를 복사할 수 있는 고급 유틸리티입니다.
SET	Windows 환경 변수를 보여주거나, 설정하거나, 지웁니다.
SETLOCAL	배치 파일에서 환경 변경의 지역화를 시작합니다. (set local)
SC	서비스를 표시하거나 구성합니다(백그라운드 작업). (service control)
SCHTASKS	컴퓨터에서 실행할 명령과 프로그램을 예약합니다. (schedule tasks)
SHIFT	배치 파일에서 바꿀 수 있는 매개 변수의 위치를 바꿉니다.
SHUTDOWN	컴퓨터의 로컬 또는 원격 종료를 허용합니다.
SORT	입력을 정렬합니다.
START	지정된 프로그램이나 명령을 별도의 창에서 시작합니다.
SUBST	경로를 드라이브 문자로 지정합니다. (substitution)
SYSTEMINFO	특정 컴퓨터의 속성과 구성을 표시합니다. (system infomation)
TASKLIST	서비스를 포함한 실행 중인 모든 작업을 표시합니다.
TASKKILL	실행 중인 프로세스나 응용 프로그램을 중지합니다. (task kill)
TIME	시스템 시간을 보여주거나 설정합니다.
TITLE	CMD.EXE 세션에 대한 창의 창 제목을 설정합니다.
TREE	드라이브 또는 경로의 디렉터리 구조를 그래픽으로 화면에 표시합니다.
TSKILL	TASKKILL과 유사하지만 기능이 적고 강제종료 기능이 없습니다. 프로세스 이름 앞에 (뒤에) .exe 를 붙이지 않습니다.
TYPE	텍스트 파일의 내용을 보여줍니다.
VER	Windows 버전을 보여줍니다. (version)
VERIFY	파일이 디스크에 올바로 쓰였는지 검증할지 여부를 지정합니다.
VOL	디스크 볼륨 이름과 일련 번호를 보여줍니다. (volume)
XCOPY	파일과 디렉터리 트리를 복사합니다. (extended copy)
WMIC	대화형 명령 셸 내의 WMI 정보를 표시합니다. (WMI command-line)